ZZZZZZZZZZZZZZZZZZZZ
Z..................Z
Z..................Z
Z........ZZ........Z
Z..G...............Z
Z..G...............Z
Z..G...........G...Z
Z..ZZZZZZ..ZZZZGZ..Z
Z..............G...Z
Z......G........|..Z
Z......G........|..Z
Z..O...G....|......Z
Z...........|......Z
Z...........|......Z
ZZZZZZZZZZZZZZZZZZZZ