ZZZZZZZZZZZZZZZZZZZZ
Z..................Z
Z.........O........Z
Z..B.....ZZB.......Z
Z..B.......B.......Z
Z..B...............Z
Z..B...........R...Z
Z..ZZZZZZ..ZZZZRZ..Z
Z..............R...Z
Z......B........|..Z
Z.R....B........|..Z
Z.R....B....|......Z
Z...........|......Z
Z...........|......Z
ZZZZZZZZZZZZZZZZZZZZ