ZZZZZZZZZZZZZZZZZZZZ
Z..................Z
Z.........O........Z
Z..G.....ZZG.......Z
Z..G...............Z
Z..G...............Z
Z..G...........G...Z
Z..ZZZZZZ..ZZZZGZ..Z
Z..............G...Z
Z......G........|..Z
Z......G........|..Z
Z......G....|......Z
Z...........|......Z
Z...........|......Z
ZZZZZZZZZZZZZZZZZZZZ