ZZZZZZZZZZZZZZZZZZZZ
Z..................Z
Z.........O........Z
Z..B.....ZZB.......Z
Z..B...............Z
Z..B...............Z
Z..B...........B...Z
Z..ZZZZZZ..ZZZZBZ..Z
Z..............B...Z
Z......B........|..Z
Z......B........|..Z
Z......B....|......Z
Z...........|......Z
Z...........|......Z
ZZZZZZZZZZZZZZZZZZZZ