ZZZZZZZZZZZZZZZZZZZZ
Z..................Z
Z.........OB.......Z
Z..B.....ZZB.......Z
Z..B...R...........Z
Z..B...R.......R...Z
Z..B...........R...Z
Z..BZZZZZ..ZZZZRZ..Z
Z..................Z
Z......B........|..Z
Z..R...B........|..Z
Z..R...B....|......Z
Z..R........|......Z
Z...........|......Z
ZZZZZZZZZZZZZZZZZZZZ