IIIIIIIIIIIIIIIIIIII
I..................I
I..................I
I........II........I
I..G...............I
I..G...............I
I..G...........G...I
I..IIIIII..IIIIGI..I
I..............G...I
I......G........|..I
I......G........|..I
I......G....|......I
I...........|......I
I...........|......I
IIIIIIIIIIIIIIIIIIII